15x20
01
....................
.                  .
.                  .
.                  .
....................
..{--------------}..
..|              |..
..| S  @====$  e |..
..|              |..
..[--------------]..
....................
....            ....
....            ....
....            ....
....            ....