15x20
1
....................
.                  .
.                  .
.                  .
....................
..{--------------}..
..|              |..
..| S  @====$  e |..
..|              |..
..[--------------]..
....................
.....          .....
.....          .....
....................
....................