15x20
6
....................
..{--------------}..
..|           C C|..
..|s  p    p     |..
..|             C|..
..>------y-------<..
..|     e|       |..
..>)     >---} (-<..
..|      |  B|   |..
..|    {-]   |   |..
..|    |    B| p |..
..>L---^-}   |   |..
..|     k|   |  A|..
..[------^---^---]..
....................
....................
..{--------------}..
..|           c c|..
..|s  p    p     |..
..|             c|..
..>------y) (----<..
..|     e|       |..
..>)     >---} (-<..
..|      |  B|   |..
..|    {-]   |   |..
..|    |    B| p |..
..>L---^-}   |   |..
..|     k|   |  A|..
..[------^---^---]..
....................
....................
..{--------------}..
..|           c c|..
..|s  p    p     |..
..|             c|..
..>------y) (----<..
..|     e|       |..
..>)     >---} (-<..
..|      |  B|   |..
..|    {-]   |   |..
..|    |    B| p |..
..>L---^-}   ,   |..
..|     k|      a|..
..[------^-------]..
....................
....................
..{--------------}..
..|           c c|..
..|s  p    p     |..
..|             c|..
..>------y) (----<..
..|     e|       |..
..>)     >---} (-<..
..|      |  b|   |..
..|    {-]   |   |..
..|    |    b| p |..
..>L---] i   ,   |..
..|     k|      a|..
..[------^-------]..
....................
....................
..{--------------}..
..|           c c|..
..|s  p    p     |..
..|             c|..
..>------y) (----<..
..|     e|       |..
..>)     >---} (-<..
..|      |  b|   |..
..|    {-]   |   |..
..|    |    b| p |..
..>D---] i   ,   |..
..|      |      a|..
..[------^-------]..
....................
....................
..{--------------}..
..|           c c|..
..|s  p    p     |..
..|             c|..
..>------y) (----<..
..|     e|       |..
..>)     >---} (-<..
..|      |  b|   |..
..|    {-]   |   |..
..|    |    b| p |..
..>d---] i   ,   |..
..|      |      a|..
..[------^-------]..
....................