15x20
1
....................
.......{-}..........
.......| |..........
.......| [------}...
.......|        |...
.......| {--} {-]...
.......|s|..| |.....
.......[-]..| |.....
............| |.....
.......{----] |.....
.......|#!    |.....
.......[------].....
....................
....................
....................
